S......#...#...........#.........#.#...................................
######.#.#.#.#######.#.###.#####.#.#...#...............................
.......#.#...#.....#.#.....#.......#...#...............................
.###.###.####..#...#.###.#####.######..#...............................
.#...#...#.....#.#.#.#...#...#...#.....#...............................
.#.###.#########.###.#####.#.###.#.#####.##............................
.#...#.....#...#...#.......#...#.#...#...#.#...........................
.#########.#.#.#.#.###########.#####.#.#.....#.........................
...........#.#.#.#...#...#.....#...#.#.#.#.............................
.###########.#..#....#.#.#.#####.#.#.#.#...............................
.......#.....#.#...#.#.#...#.....#...#.#...............................
######.#.#####.#.#.##..#####.######.##.#...............................
.....#...#...#.#.....#.......#.....#...................................
.#.#######..##.###.#.#########..##.####................................
...#.........#...#.#...........#.#.....................................
#..#.####.##.###.#.#..##.#.##.#......#...#.............................
...#.....#.....#.#...........#.........................................
..######.#.#####.#...#...............#.................................
.....#...#.......#.....#.........#.....................................
...#.#.####.######.#...#...#...........................................
.#.#.#.#...#.....#.....#...............................................
...#.#.#.#.#.#.###.........#...................................#.......
.....#...#.#.#...................................................#.....
....######.#.....#....#....#........................................##.
.......#...#.......................................................#...
.#####.#.###.#.#.....................................#.....##..##.....#
.#...#.#.#.#.#...................................................#.....
.###.#.#.#.#.####........................................#...#.#.#..##.
...#.#...#.#...............................................#...#.......
##.#.#####.#..#......................................#...#..###########
.#...#.........#.........................................#.#...#.......
.###.#..###...#..#.............................#.#...#.#.#..##.#.##.##.
.#...#.#.......................................................#...#...
.#.###......#........................................#.###########.#.#.
...#.#.#.......................................#...#.#.#...#.....#.#.#.
.##.............................................#..#.###.#.#.###.#.#.#.
...#...............................................#...#.#...#.#...#.#.
...#.......#......................................#.##.#..####..####.#.
...#.............................................#.....#.#.........#.#.
......#........................................#.#..##.#.#.#.#..#.#..#.
.................................................#...#.#.#...#.....#.#.
.#...............#.............................###.#.#.#.#....####.#.##
.................................................#.#.#.#.#.........#...
...........................................#.#...#.#.#.#.#..#.#.##.###.
...................................................#.#.#.#.....#...#...
.........................................#.....#...#.###.####..#...#.#.
...................................................#.#...#...#.#...#.#.
.............................#........#.#...#####..#.#.###.#.#.#####.#.
.............................................#.....#.#.....#...#.....#.
.............................................#.#####.#########.#.#...#.
...............................................#...............#.#.#...
.............................#.#.#...##..#...#.#..###########..#.#.#.##
.....................................#.......#...#.#...........#.#.....
.................#.........##.#.##.#....###....#.#.#.#.###..####.#####.
.....................................#.#.....#.#.....#...#.#...#.....#.
...........................#########.#.#..####.###.#.###.###.#.###.#.#.
.....................#.....#.#.......#...........#.....#.#...#...#.#.#.
.........................###.#.#.############.##.#.####..#.#####.###.#.
.......................#.......#.#.....#.....#...#.#.....#...#.#...#.#.
...........................#...#.#.#.#.#.###.#.#.###.###.###.#.###.#.##
...............................#...#.#...#.#.#.......#...#...#.....#...
.........................#..########.#####.#.#.###########.###.#######.
.....................................#...#...#.#...........#.#.#.....#.
.................................#.##..#.#.#####.##########..#.###.#.#.
...................................#...#.#.....#.#.........#...#...#...
.......................#...........#..##.#####.#.##..###.#.#.###.#####.
...............................#.....#.......#...#.....#.#.#.#.......#.
........................................####.#####..##...#.#.#######.#.
...........................................#...#...#.......#...#.....#.
...............................................#.......###.###.#.#####.
.................................................#...........#...#....E